25 25 25 25 25 25 25 25 25 25 25 25 25 25 25 25 25 25 25 25 25 25 25 25 25 25 25 25 25 25 25 25 25 25 25 25 25 25 25 25 25 25 25 25 25 25 25 25 25 25 
25 25 25 25 25 25 25 25 25 25 25 25 25 25 25 25 25 25 25 25 25 25 25 25 25 25 25 25 25 25 25 25 25 25 25 25 25 25 25 25 25 25 25 25 25 25 25 25 25 25 
25 25 25 25 25 25 25 25 25 25 25 25 25 25 25 25 25 25 25 25 25 25 25 25 25 11 12 12 12 12 13 25 25 25 25 25 25 25 25 25 25 25 25 25 25 25 25 25 25 25 
25 25 25 25 25 25 25 25 25 25 25 25 25 25 25 25 25 25 25 25 25 25 25 25 25 14 15 15 15 15 16 25 25 25 25 25 25 25 25 25 25 25 25 25 25 25 25 25 25 25 
25 25 25 25 25 25 25 25 25 25 25 25 25 25 25 25 25 25 25 25 25 25 25 25 25 14 15 31 18 18 19 25 25 25 25 25 25 11 12 13 25 25 25 25 11 12 12 13 25 25 
25 25 25 25 25 25 25 25 25 25 25 25 25 25 25 25 25 25 25 25 25 25 25 25 25 14 15 16 25 25 25 25 25 25 25 25 25 14 15 16 25 25 25 25 14 15 15 16 25 25 
25 25 25 25 25 25 25 25 25 25 25 25 25 25 25 25 25 25 25 25 25 25 25 25 25 14 15 16 25 25 25 25 25 25 25 25 25 14 15 16 25 25 25 25 14 15 31 19 25 25 
25 25 25 25 25 25 25 25 25 25 25 25 25 25 25 25 25 25 25 25 25 25 25 25 25 14 15 16 25 25 25 25 25 25 25 25 25 14 15 33 13 25 25 11 34 15 16 25 25 25 
25 25 25 25 25 25 25 25 25 25 25 25 25 25 25 25 25 25 25 25 25 25 25 25 25 14 15 16 25 25 25 25 25 25 25 25 11 34 15 15 33 12 12 34 15 15 16 25 25 25 
25 25 25 25 25 25 25 25 25 25 25 25 25 25 25 25 25 25 11 12 12 12 12 12 12 34 15 16 25 25 25 25 25 11 12 12 34 15 15 15 15 15 15 15 15 15 16 25 25 25 
25 25 25 25 25 25 25 25 25 25 25 25 25 25 25 25 25 25 14 15 15 15 15 15 15 15 15 33 13 25 25 25 11 34 15 15 15 15 15 15 15 15 15 15 15 15 16 25 25 25 
25 25 25 25 25 25 25 25 25 25 25 25 25 25 25 25 11 12 34 15 15 15 15 15 15 15 15 15 33 12 12 12 34 15 15 15 15 15 15 15 15 15 15 15 15 15 33 13 25 25 
25 25 25 25 25 25 25 25 25 25 25 25 25 25 25 25 14 15 15 15 15 15 15 15 15 15 15 15 15 15 15 15 15 15 15 15 15 15 15 15 15 15 15 15 15 15 15 16 25 25 
25 25 25 25 25 25 25 25 25 25 25 25 25 25 25 25 14 15 15 15 15 15 15 15 15 15 15 31 18 18 18 18 32 15 15 15 15 15 15 15 15 15 15 15 15 15 31 19 25 25 
25 25 25 25 25 25 25 25 25 25 25 25 25 25 25 25 14 15 15 15 15 15 15 15 15 15 15 16 25 25 25 25 17 32 15 15 15 15 15 15 15 15 15 15 15 31 19 25 25 25 
25 25 25 25 25 25 25 25 25 25 25 25 25 25 25 25 17 18 32 15 15 15 15 15 15 15 31 19 25 25 25 25 25 17 32 15 31 18 18 18 18 18 18 18 18 19 25 25 25 25 
25 25 25 25 25 25 25 25 25 25 25 25 25 25 25 25 25 25 17 18 18 18 18 18 18 18 19 25 25 25 25 25 25 25 14 15 16 25 25 25 25 25 25 25 25 25 25 25 25 25 
25 25 25 25 25 25 25 25 25 25 25 25 25 25 25 25 25 25 25 25 25 25 25 25 25 25 25 25 25 25 25 25 25 25 14 15 16 25 25 11 12 12 12 12 13 25 25 25 25 25 
25 25 25 25 25 25 25 25 25 25 25 25 25 25 25 25 25 25 25 25 25 25 25 25 25 25 25 25 25 25 25 25 25 25 14 15 16 25 25 14 15 15 15 15 33 13 25 25 25 25 
25 25 25 25 25 25 25 25 25 25 25 25 25 25 25 25 25 25 25 25 25 25 25 25 25 25 25 25 25 25 25 25 25 25 14 15 33 12 12 34 15 15 15 15 15 33 13 25 25 25 
25 25 25 25 25 25 25 25 25 25 25 25 25 25 25 25 25 25 25 25 25 25 25 25 25 25 25 25 25 25 25 25 25 25 14 15 15 15 15 15 15 15 15 15 15 15 16 25 25 25 
25 25 25 25 25 25 25 25 25 25 25 25 25 25 25 25 25 25 25 25 25 25 25 25 25 25 25 25 25 25 25 25 25 25 17 18 18 18 32 15 15 15 15 15 15 15 16 25 25 25 
25 25 25 25 25 25 25 25 25 25 25 25 25 25 25 25 25 25 25 25 25 25 25 25 25 25 25 25 25 25 25 25 25 25 25 25 25 25 14 15 15 15 15 15 15 15 16 25 25 25 
25 25 25 25 25 25 25 25 25 25 25 25 25 25 25 25 25 25 25 25 25 25 25 25 25 25 25 25 25 25 25 25 25 25 25 25 25 25 14 15 15 15 15 15 15 15 16 25 25 25 
25 25 25 25 25 25 25 25 25 25 25 25 25 25 25 25 25 25 25 25 25 25 25 25 25 25 25 25 25 25 25 25 25 25 25 25 25 25 14 15 31 18 18 18 18 18 19 25 25 25 
25 25 25 25 25 25 25 25 25 25 25 25 25 25 25 25 25 25 25 25 25 25 25 25 25 25 25 25 25 25 25 25 25 25 25 25 25 25 14 15 16 25 25 25 25 25 25 25 25 25 
25 25 25 25 25 25 25 25 25 25 25 25 25 25 25 25 25 25 25 25 25 25 25 25 25 25 25 25 25 25 25 25 25 25 25 25 25 25 14 15 16 25 25 25 25 25 25 25 25 25 
25 25 25 25 25 25 25 25 25 25 25 25 25 25 25 25 25 25 25 25 25 25 25 25 25 25 25 25 25 25 25 25 25 25 25 25 25 25 14 15 16 25 25 25 25 25 25 25 25 25 
25 25 25 25 25 25 25 25 25 25 25 25 25 25 25 25 25 25 25 25 25 25 25 25 25 25 25 25 25 25 25 25 25 25 25 25 25 25 14 15 16 25 25 11 12 13 25 25 25 25 
25 25 25 25 25 25 25 25 25 25 25 25 25 25 25 25 25 25 25 25 25 25 25 25 25 25 25 25 15 15 15 15 15 15 12 12 12 12 34 15 16 25 25 14 15 16 25 25 25 25 
25 25 25 25 25 25 25 25 25 25 25 25 25 25 25 25 25 25 25 25 25 25 25 25 25 25 25 15 15 15 15 15 15 15 15 15 15 15 15 15 33 12 12 34 15 33 13 25 25 25 
25 25 25 25 25 25 25 25 25 25 25 25 25 25 25 25 25 25 25 25 25 25 25 25 25 25 25 15 15 15 15 15 15 15 15 15 15 15 15 15 15 15 15 15 15 15 33 13 25 25 
25 25 25 25 25 25 25 25 25 25 25 25 25 25 25 25 25 25 25 25 25 25 25 25 25 25 25 15 15 15 15 15 15 15 15 15 15 15 15 15 15 15 15 15 15 15 15 16 25 25 
25 25 25 25 25 25 25 25 25 25 25 25 25 25 25 25 25 25 25 25 25 25 25 25 25 25 25 15 15 15 15 15 15 15 15 15 15 15 15 15 15 15 15 15 15 15 15 16 25 25 
25 25 25 25 25 25 25 25 25 25 25 25 25 25 25 25 25 25 25 25 25 25 25 25 25 25 25 15 15 15 15 15 15 15 15 15 15 15 15 15 15 15 15 15 15 15 15 16 25 25 
25 25 25 25 25 25 25 25 25 25 25 25 25 25 25 25 25 25 25 25 25 25 25 25 25 25 25 15 15 15 15 15 15 15 15 15 15 15 15 15 15 15 15 15 15 15 15 16 25 25 
25 25 25 25 25 25 25 25 25 25 25 25 25 25 25 25 25 25 25 25 25 25 25 25 25 25 25 15 15 15 15 15 15 15 15 15 15 15 15 15 15 15 15 15 15 15 15 16 25 25 
25 25 25 25 25 25 25 25 25 25 25 25 25 25 25 25 25 25 25 25 25 25 25 25 25 25 25 15 18 18 18 18 18 18 18 18 18 18 18 18 18 18 18 18 18 18 18 19 25 25 
25 25 25 25 25 25 25 25 25 25 25 25 25 25 25 25 25 25 25 25 25 25 25 25 25 25 25 25 25 25 25 25 25 25 25 25 25 25 25 25 25 25 25 25 25 25 25 25 25 25 
25 25 25 25 25 25 25 25 25 25 25 25 25 25 25 25 25 25 25 25 25 25 25 25 25 25 25 25 25 25 25 25 25 25 25 25 25 25 25 25 25 25 25 25 25 25 25 25 25 25 
